10 10 10 10 10 10 10 10 10 10 10 10 10 10 10 10
10 3 0 0 0 0 0 0 0 0 0 0 0 0 0 10
10 0 0 0 0 2 0 0 0 8 0 0 6 0 0 10
10 24 0 0 0 0 0 24 7 0  0 5 0 0 10
10 0 24 3 0 0 0 0 0 0 10 0 4 0 0 10
10 0 6 0 0 1 0 0 0 0 10 0 0 0 0 10
10 0 5 0 0 16 24 0 0 0 10 0 0 0 0 10
10 0 4 0 0 0 0 0 0 0 0 0 0 0 0 10
10 0 0 0 0 0 0 0 0 0 0 8 8 8 0 10
10 0 0 11 12 13 14 15 0 0 0 8 8 8 0 10
10 0 0 0 0 0 0 0 0 0 0 0 0 0 0 10
10 10 10 10 10 10 10 10 10 10 10 10 10 10 10 10