25 5 25 5 25 5 25 5 25 5 25 5 25 5 25 5 25 5 25 5 25 5 25 5 25 5 25 5 25 5 25 5 25 5 25 5 25 5 25 5 25 5 25 5 25 5 25 5 25 5
5 25 5 25 5 25 5 25 5 25 5 25 5 25 5 25 5 25 5 25 5 25 5 25 5 25 5 25 5 25 5 25 5 25 5 25 5 25 5 25 5 25 5 25 5 25 5 25 5 25
25 5 25 5 4 5 4 5 4 5 4 5 4 5 4 5 4 5 4 5 4 5 4 5 4 5 4 5 4 5 4 5 4 5 4 5 4 5 4 5 4 5 4 5 4 5 4 5 25 5
5 25 5 4 0 4 0 4 0 4 0 4 0 4 0 4 0 4 0 4 0 4 0 4 0 4 0 4 0 4 0 4 0 4 0 4 0 4 0 4 0 4 0 4 0 4 0 25 5 25
25 5 25 0 0 0 0 0 0 0 0 0 0 0 0 0 0 0 0 0 0 0 0 0 0 0 0 0 0 0 0 0 0 0 0 0 0 0 0 0 0 0 0 0 0 0 0 5 25 5
5 25 5 0 0 2 2 2 2 2 0 0 1 0 0 0 2 2 2 2 2 2 0 0 79 78 81 0 0 0 0 0 0 0 0 0 0 0 0 0 0 0 0 0 0 0 0 25 5 25
25 5 25 0 2 2 82 83 2 0 0 0 0 0 0 0 0 2 2 82 83 2 0 0 74 24 76 0 0 0 0 0 0 0 0 0 0 0 0 0 0 0 0 0 0 0 0 5 25 5
5 25 5 0 2 2 84 85 0 0 0 0 2 2 0 0 0 0 2 84 85 2 0 0 74 24 76 0 0 0 0 0 0 0 0 0 0 0 0 0 0 0 0 0 0 0 0 25 5 25
25 5 25 0 0 2 86 87 0 0 0 2 2 2 2 0 0 0 2 86 87 2 0 0 74 24 76 0 0 0 0 0 0 0 0 0 0 0 0 0 0 0 0 0 0 0 0 5 25 5
5 25 5 0 0 2 0 0 0 0 2 2 82 83 2 2 0 0 0 2 2 0 0 0 74 24 76 0 0 0 0 0 0 0 0 0 0 0 0 0 0 0 0 0 0 0 0 25 5 25
25 5 25 0 0 0 0 0 0 0 2 2 84 85 2 2 0 0 0 0 0 0 0 0 74 24 76 0 0 0 0 0 0 0 0 0 0 0 0 0 0 0 0 0 0 0 0 5 25 5
5 25 5 0 0 0 1 0 0 0 2 2 86 87 2 2 0 0 0 0 0 1 0 0 74 24 76 0 0 0 0 0 0 0 0 0 0 0 0 0 0 0 0 0 0 0 0 25 5 25
25 5 25 0 2 0 0 0 0 0 0 2 2 2 2 0 0 0 0 0 0 0 0 0 74 24 76 0 0 0 0 0 0 0 0 0 0 0 0 0 0 0 0 0 0 0 0 5 25 5
5 25 5 0 2 2 0 0 0 0 0 0 2 2 0 0 0 0 0 0 0 0 0 0 74 24 76 0 0 0 0 0 0 0 0 0 0 0 0 0 0 0 0 0 0 0 0 25 5 25
25 5 25 0 2 2 2 2 0 0 0 0 0 0 0 0 0 0 2 2 2 0 0 0 74 24 76 0 0 0 0 0 0 0 0 0 0 0 0 0 0 0 0 0 0 0 0 5 25 5
5 25 5 0 0 2 2 2 2 2 0 0 0 0 1 0 0 2 2 2 2 2 0 0 74 24 76 0 0 0 0 0 0 0 0 0 0 0 0 0 0 0 0 0 0 0 0 25 5 25
25 5 25 0 0 0 0 0 0 0 0 0 0 0 0 2 2 2 2 2 0 0 0 0 74 24 76 0 0 0 0 0 0 0 0 0 0 0 0 0 0 0 0 0 0 0 0 5 25 5
5 25 5 0 0 0 0 0 0 0 0 0 0 0 0 0 0 0 0 0 0 0 0 0 74 24 76 0 0 0 0 0 0 0 0 0 45 46 47 48 46 47 49 0 0 0 0 25 5 25
25 5 25 0 0 6 34 35 35 35 36 0 0 0 6 34 35 35 35 36 0 0 0 0 74 24 76 0 0 26 27 28 29 0 82 83 50 51 52 53 51 52 54 82 83 0 0 5 25 5
5 25 5 0 0 5 37 38 38 38 39 15 0 0 5 37 38 38 38 39 15 0 0 0 74 24 76 0 0 30 31 32 33 0 84 85 55 56 57 58 56 57 59 84 85 0 0 25 5 25
25 5 25 0 0 4 40 41 42 43 44 14 0 0 4 40 41 42 43 44 14 0 0 0 74 24 76 0 0 20 21 22 23 0 86 87 60 61 68 62 63 64 65 86 87 0 0 5 25 5
5 25 5 0 0 0 72 72 72 0 0 0 0 0 0 73 73 73 0 0 0 0 0 1 74 24 76 0 0 16 17 18 19 0 0 0 69 70 71 0 66 67 0 0 0 0 0 25 5 25
25 5 25 0 0 0 0 0 0 0 0 0 0 0 0 0 0 0 0 0 0 0 0 0 74 24 76 0 0 72 72 0 0 0 0 0 0 0 0 0 0 0 0 0 0 0 0 5 4 5
5 25 5 0 0 0 0 0 0 0 0 0 0 0 0 0 0 0 0 0 0 0 0 0 74 24 76 0 0 0 0 0 0 0 0 0 0 0 0 0 0 0 0 0 0 0 0 4 7 4
25 5 25 0 79 78 78 78 78 78 78 78 78 78 78 78 78 78 78 78 78 78 78 78 24 24 24 78 78 78 78 78 78 78 78 78 78 78 78 78 78 78 78 78 78 78 78 78 78 78
5 25 5 0 74 24 24 24 24 24 24 24 24 24 24 24 24 24 24 24 24 24 24 24 24 24 24 24 24 24 24 24 24 24 24 24 24 24 24 24 24 24 24 24 24 24 24 24 24 24
25 5 25 0 75 80 80 80 80 80 80 80 80 80 80 80 80 80 80 80 80 80 80 80 24 24 24 80 80 80 80 80 80 80 80 80 80 80 80 80 80 80 80 80 80 80 80 80 80 80
5 25 5 0 0 0 0 0 0 0 0 0 0 0 0 0 0 0 0 0 0 0 0 0 74 24 76 0 0 0 0 0 0 0 0 0 0 0 0 0 0 0 0 0 0 0 0 6 5 6
25 5 25 0 0 0 0 0 0 0 0 0 0 0 0 0 0 0 0 0 0 0 0 0 74 24 76 0 0 0 0 0 0 0 0 0 0 0 0 0 0 0 0 0 0 0 0 5 25 5
5 25 5 0 0 6 34 35 35 35 36 0 0 0 6 34 35 35 35 36 0 0 0 0 74 24 76 0 0 0 6 34 35 35 35 36 0 0 0 6 34 35 35 35 36 0 0 25 5 25
25 5 25 0 0 5 37 38 38 38 39 15 0 0 5 37 38 38 38 39 15 0 0 0 74 24 76 0 0 0 5 37 38 38 38 39 15 0 0 5 37 38 38 38 39 15 0 5 25 5
5 25 5 0 0 4 40 41 42 43 44 14 0 0 4 40 41 42 43 44 14 0 0 0 74 24 76 0 0 0 4 40 41 42 43 44 14 0 0 4 40 41 42 43 44 14 0 25 5 25
25 5 25 0 0 0 1 1 1 0 0 0 0 0 0 69 70 71 0 0 0 0 0 0 74 24 76 0 0 0 0 73 73 73 0 0 0 0 0 0 69 70 71 0 0 0 0 5 25 5
5 25 5 0 0 0 0 0 0 0 0 0 0 0 0 0 0 0 0 0 0 0 0 0 74 24 76 0 0 0 0 0 0 0 0 0 0 0 0 0 0 0 0 0 0 0 0 25 5 25
25 5 25 0 0 0 0 0 0 0 0 0 0 0 0 0 0 0 0 0 0 0 0 0 74 24 76 0 0 0 0 0 0 0 0 0 0 0 0 0 0 0 0 0 0 0 0 5 25 5
5 25 5 0 0 0 0 0 0 0 0 0 0 0 0 0 0 0 0 0 0 0 0 0 74 24 76 0 0 0 0 0 0 0 0 0 0 0 0 95 96 96 96 97 0 0 0 25 5 25
25 5 25 0 0 0 0 0 0 0 0 0 0 0 0 0 0 0 0 0 0 0 0 0 74 24 76 0 0 0 95 96 96 97 0 0 0 0 0 98 99 99 99 100 0 0 0 5 25 5
5 25 5 0 0 0 0 0 0 0 0 0 0 0 0 0 0 0 0 0 0 0 0 0 74 24 76 0 0 0 98 99 99 100 0 0 0 0 0 98 99 99 99 100 0 0 0 25 5 25
25 5 25 0 0 0 0 0 0 0 0 0 0 0 0 0 0 0 0 0 0 0 0 0 74 24 76 0 1 0 98 99 99 100 0 0 0 0 0 101 102 102 102 103 0 0 0 5 25 5
5 25 5 0 0 0 0 0 0 0 0 0 0 0 0 0 0 0 0 0 0 0 0 0 74 24 76 0 0 0 101 102 102 103 0 0 0 0 0 0 0 0 0 0 0 0 0 25 5 25
25 5 25 0 0 0 0 0 0 0 0 0 0 0 0 0 0 0 0 0 0 0 0 0 74 24 76 0 0 0 0 0 0 0 0 0 0 0 0 0 0 0 0 0 1 0 0 5 4 5
5 25 5 0 0 0 0 0 0 0 0 0 0 0 0 0 0 0 0 0 0 0 0 0 74 24 76 0 0 95 97 0 0 0 0 0 1 0 0 0 0 0 0 0 0 0 0 4 0 4
25 5 25 0 0 0 0 0 0 0 0 0 0 0 0 0 0 0 0 0 0 0 0 0 74 24 76 0 0 101 103 0 0 0 0 0 0 0 0 0 0 0 0 0 0 9 88 88 88 88
5 25 5 0 0 0 0 0 0 0 0 0 0 0 0 0 0 0 0 0 0 0 0 0 74 24 76 0 0 0 0 0 0 0 0 0 0 0 0 0 0 9 88 88 88 90 10 10 10 10
25 5 25 0 0 0 0 0 0 0 0 0 0 0 0 0 0 0 0 0 0 0 0 0 74 24 76 0 0 0 0 0 0 0 0 9 88 91 92 93 88 90 10 10 10 10 10 10 10 10
5 25 5 0 0 0 0 0 0 0 0 0 0 0 0 0 0 0 0 0 0 0 0 7 75 80 77 0 0 0 0 9 88 88 88 90 10 91 92 93 10 10 10 10 10 10 10 10 10 10
25 5 25 0 6 0 6 0 6 0 6 0 6 0 6 0 6 0 6 0 6 0 6 0 6 0 6 0 0 0 0 89 10 10 10 10 10 91 92 93 10 10 10 10 10 10 10 10 10 10
5 25 5 6 5 6 5 6 5 6 5 6 5 6 5 6 5 6 5 6 5 6 5 6 5 6 5 6 9 88 88 90 10 10 10 10 10 91 92 93 10 10 10 10 10 10 10 10 10 10
25 5 25 5 25 5 25 5 25 5 25 5 25 5 25 5 25 5 25 5 25 5 25 5 25 5 25 5 89 10 10 10 10 10 10 10 10 94 94 94 10 10 10 10 10 10 10 10 10 10
5 25 5 25 5 25 5 25 5 25 5 25 5 25 5 25 5 25 5 25 5 25 5 25 5 25 5 25 89 10 10 10 10 10 10 10 10 10 10 10 10 10 10 10 10 10 10 10 10 10